PE-0-3 PE-0-4 PE-0-2
PE-2-7 PP-2-8 PE-2-6
PP-2-8 PE-2-7
PE-0-2 PE-1-2 PE-0-3
PE-0-6 PE-1-6 PE-0-5
GH-2-4 PE-2-5 PE-2-3
PE-2-1 PE-2-2 PM-2-0
PE-2-3 GH-2-4 PE-2-2
PM-2-0 PE-2-1
PE-2-2 PE-2-1 PE-2-3 PE-1-2
PE-0-4 PE-0-3 PE-0-5
PE-2-6 PE-2-7 PE-1-6 PE-2-5
PE-0-5 PE-0-4 PE-0-6
PE-1-6 PE-0-6 PE-2-6
PE-2-5 PE-2-6 GH-2-4
PE-1-2 PE-0-2 PE-2-2
