PE-0-1 PE-0-0 PP-0-2
PE-0-0 PE-1-0 PE-0-1
PP-0-2 GH-1-2 PE-0-1
PE-3-0 PE-2-0 GH-4-0
PE-3-2 PM-4-2 PE-2-2
PE-2-1 PE-2-2 PE-2-0
PE-2-0 PE-1-0 PE-2-1 PE-3-0
PE-2-2 GH-1-2 PE-2-1 PE-3-2
GH-4-0 PE-4-1 PE-3-0
PM-4-2 PE-4-1 PE-3-2
PE-4-1 PM-4-2 GH-4-0
PE-1-0 PE-0-0 PE-2-0
GH-1-2 PP-0-2 PE-2-2
